move south | mole source | move suth | more south
the sun shine | to sit shone | the sos shining | three soy shame
jump high | july heat | jump hat | just hue
fast car | feast cat | first cap | for cast
red apple | read ample | red apply | rod apple
big dog | bit dug | big dot | bug dig
cold day | coal dye | cold dry | coil day
play game | plea gnome | play gain | ploy gamer
dark night | dart knit | dark nit | dare knight
sweet treat | sweat tree | sweet treetop | set treat
old book | old brook | owl book | oil bok
high hill | higher hilt | high hilly | hit hill
green leaf | green lief | greet leaf | grin leaf
open field | opus field | open fife | upon field
warm hug | worm huge | warm hulk | warp hug
true story | truce storey | true stork | thru story
deep forest | dip foray | deep forge | deer forest
bright idea | bite ideal | bright ideal | braid idea
cozy home | cozen gnome | cozy holm | cozy hose
silent night | silt knight | silent nit | slid night
big fish | bit fish | big fiche | bug fish
hot pizza | hut pizzazz | hot pizzicato | hat pizza
open sky | opus skylark | open skylight | upon sky
silver moon | sliver moon | silver moose | sly moon
warm fire | worm flier | warm firth | warp fire
true friend | truce fiend | true fiend | thru friend
happy moment | hippy momentum | happy memento | harpy moment
deep thought | dip throat | deep throb | deer thought
green apple | green ample | greet apple | grin ample
loud laughter | lout laughter | loud lather | lid lathe
cold ice | coal slice | cold iced | coil ice
bright light | bite flight | bright flight | braid light
open road | opus rood | open rove | upon road
tall mountain | tale mountain | tall mound | tail mountain
quick response | quirk response | quick respawn | quill response
cozy blanket | cozen blanket | cozy blank | cozy bank
strong tree | stung treetop | strong trot | stork tree
deep sea | dip seal | deep seal | deer sea
old house | old horse | owl house | oil house
warm tea | worm teacup | warm teak | warp tea
true love | truce louver | true luv | thru love
green grass | green glasses | greet grassy | grin grass
open mind | opus mined | open mined | upon mind
sweet honey | sweat honey | sweet hone | set honey
cold wind | coal window | cold wing | coil wind
bright sun | bite sung | bright sung | braid sun
cozy chair | cozen chaise | cozy chains | cozy chalk
loud music | lout musket | loud musk | lid must
clear sky | cleat skylight | clear skyway | claret sky
fast car | feast carpet | first card | for cart
deep river | dip riven | deep rives | deer river
old tree | old trove | owl tree | oil tree
warm day | worm daisy | warm daze | warp day
true story | truce stork | true stork | thru story
big city | bit cymbal | big cyst | bug city
silent night | silt nightly | silent nit | slid night
bright moon | bite monsoon | bright morn | braid moon
happy song | hippy scone | happy sown | harpy song
quick thinking | quirk thinking | quick thin | quill thinking
cozy room | cozen rook | cozy rookie | cozy roof
strong wind | stung windy | strong windy | stork wind
deep sleep | dip sleeve | deep sleek | deer sleep
old town | old tow | owl town | oil town
apple aisle apple | agile antelope ambiance | amber autumn apple | azure afternoon ambiance
brave bunny bounds | blue butterfly blooms | blue beehive buzz | baby bunnies bounce
creek curious cat | crimson cardinal chirps | cascading cherry charm | crystal clear creek
daring daisy dances | daring dawn dew | delicate dandelion dreams | dainty dragonfly dances
eagle evening embers | eagle eyed eagle | enchanting evening echoes | endless embers flicker
festive frolics fireflies | festive fall foliage | friendly forest fauna | fluffy fox frolics
gazelle golden gale | gazelle gale gusts | glowing golden meadow | graceful gazelle grazes
hound howling hiker | heavenly humming harmony | hazy harvest haze | hummingbird hovers
iceberg inkwell igloos | ivory iceberg floats | intricate ice sculptures | inky indigo inkwell
kite kindred knits | kites kiss the sky | kaleidoscope knits | kooky kangaroo kicks
lanterns linger ladybug | lilac lavender lullaby | luminous lunar light | lively ladybug lands
mirrored misty meadow | majestic mountain peaks | meandering mountain mist | mystical misty mornings
nebula nomad navigates | nimble nightingale nests | nocturnal nature nooks | nebulous nebula naps
opulent opens orange | ocean odyssey opens | opulent orange orchid | opulent ocean waves
polar peaceful paradise | playful polar bear | prancing peacock preens | painted pinecones perch
quokka quasar quivers | quiet quasar queries | quiet quokka quest | quaint quokka quietly
rainbow rustic rapids | radiant rainbow rises | rolling rapids rush | rhythmic river ripples
silver sacred stream | shy snowflake swirls | serene snow summits | shimmering silver stream
violets vibrant vistas | velvety vulture ventures | verdant valley views | vibrant vista visions
willow wild waltzing | whimsical willow weaves | wandering wild wolf | whispering willow winds
yarrow yellowed yurt | yellow yaks yawn | yesteryear's yawns yonder | yellow yarrow yields
zephyr zenith zings | zany zebra zigzags | zesty zephyr zings | zenith zircon zeal
azure azaleas abyssal | zesty zucchini zings | zero-gravity zest | azure abyssal azaleas
colossal cascade collides | cobalt cosmos calls | cosmic cascade collides | crystalline comet carves
diamond dusky dance | dewdrops dusky dusk | daffodils dance | delicate daisies drowse
ember elusive echoes | effervescent elk eludes | eternal echoes enchant | elusive ember embers
fern fir fairyland | fern fronds fiesta | fern-filled fairyland | fragrant fern fronds
glacier graceful glide | giants garnet gem | giants glide gracefully | giants glacier glows
hushed hallowed hikes | hushed humming hymn | hopeful hiker hikes | hushed hymns hum
kinetic kite kisses | knitted kelp kingdom | kaleidoscopic kitten cavorts | keen kite keepsakes
meadow melody misty | melodic meadow melodies | moonlit magnolia musings | mystical misty mountains
nimbus nymph navigates | nocturnal nymph nap | nectarous nightingale nest | nimble nymphal novelties
orchard orbs onyx | orchard owl observes | onyx obsidian orb | opulent onyx opus
pathway pebble panda | pristine pebble pathway | pastel paints peacock | poetic peacock poses
quasar questing quokka | quirky quasar quest | quiet quinoa quiche | quantum quokka queries
radiant ripples realm | radiant ruby river | rhythmic rocks realm | resplendent rosewood realm
velvet violets vibrate | vulture voyages vividly | verdant views valley | velvety violets vibrate